
CET = "countries/Empire of Cetus.txt"
COV = "countries/Corvun Confederation.txt"
LBR = "countries/Federation of Libra.txt"
ORI = "countries/Orion Republic.txt"
AUR = "countries/Kingdom of Auriga.txt"
URS = "countries/Federation of Ursa.txt"
ANT = "countries/Antares Imperium.txt"
AQU = "countries/Kingdom of Aquila.txt"
VEG = "countries/Vegan Dominion.txt"
GRS = "countries/Kingdom of Grusa.txt"
CLB = "countries/United Columban Territory.txt"
RIA = "countries/Republic of Riaa.txt"
VUL = "countries/Empire of Vulpa.txt"
TUC = "countries/Tucani Empire.txt"
CTA = "countries/Kingdom of Centauri.txt"
LAC = "countries/Lacerta.txt"
MUS = "countries/Principality of Musca.txt"
HYS = "countries/Hydrus.txt"
BCH = "countries/Bocchiland.txt"
CAI = "countries/Ca Inc.txt"
LPS = "countries/Lepus.txt"
CNS = "countries/Canis.txt"
HYR = "countries/Hydrus Commonwealth.txt"
RDN = "countries/Rodinian Mandate.txt"
LGS = "countries/Lingstonia.txt"
SKO = "countries/Skorpius.txt"
ARA = "countries/Ara.txt"
LUP = "countries/Lupus.txt"
NRM = "countries/Norma.txt"
CIR = "countries/Circinia.txt"
GEM = "countries/Gemina.txt"
QUA = "countries/Quara.txt"
EUR = "countries/Euria.txt"
PHA = "countries/Phact.txt"
NOH = "countries/Nohae.txt"